% This is a medium map
% Four victims, with obstructions

############################
#   #     #     #     #    #
#   #V    #V    #V    #    #
### ### ##### ##### ### ####
#       555             #  #
#                       #  #
#  ###3####   #### ###     #
#33#      #333#      #  #  #
#33#      #333#      #  ####
#  #### ###   ## #####33#  #
#                          #
#  ##2##### 4 ##### ##44# V#
#  #   2  #   #      #33####
#  # 2    #  2#      #22#  #
#  #####2##   ### ####  #  #
#          2               #
#     E       33        #  #
############################
