% This is a simple map
% Made it extra wide for the title to show

###########
##V      ##
#####33####
####2  ####
####E  ####
###########
