% This is a medium map
% One victim, with obstructions

############################
#   #     #     #     #    #
#   #V    #     #     #    #
### ### ##### ##### ### ####
#       444             #  #
#                       #  #
#  ### ####   #### ###     #
#33#      #333#222222#  #  #
#33#      #333#222222#  ####
#  #### ###   ## #####33#  #
#                          #
#  ## ##### 4 ##### ##44#  #
#  #222222#   #      #33####
#  #222222#  2#      #22#  #
#  ##### ##   ### ####  #  #
#          2               #
#     E       33        #  #
############################
