% This is a simple map

 ##########
 #V    V ##
  ###33###
   #2  ##
   #E  #
   #####
